UEF = "countries/UEF.txt" #England-France
ERO = "countries/ERO.txt" #Eastern Roman Empire
GAU = "countries/GAU.txt" #Gaul
GRP = "countries/GRP.txt" #Groﬂpreuﬂen
TRK = "countries/TRK.txt" #Actual Turkey!
BOL = "countries/Bolgharia.txt" #SmartGuy725, Volga Bolgars/Chuvash
KHZ = "countries/Khazaria.txt" #SmartGuy725, Khazars
ALN = "countries/Alans.txt"
ABK = "countries/Abkhazia.txt"
VAK = "countries/Vainakhia.txt"
LEK = "countries/Lekia.txt"
UDI = "countries/Udi.txt"
ASY = "countries/Assyria.txt"
RUE = "countries/Reunion.txt"
SYL = "countries/Seychelles.txt"
MAU = "countries/Mauritius.txt"
DNC = "countries/DNC.txt"
IKC = "countries/IKC.txt"
KBC = "countries/KBC.txt" 
ORC = "countries/ORC.txt"
SBC = "countries/SBC.txt"
SMC = "countries/SMC.txt"
TBC = "countries/TBC.txt"
TKC = "countries/TKC.txt"
ULC = "countries/ULC.txt"
USC = "countries/USC.txt"
AMC = "countries/AMC.txt"
TUV = "countries/Turov.txt"
PEY = "countries/Pereyaslavl.txt"
JAG = "countries/Chagatai.txt"
KRD = "countries/Kurdistan.txt"